X001111111000001111111110000000
001000001111111000000011111000
001000001000001000000010001000
001000000000000000000000001000
001000001000001000000010001000
001000001111111000000011111000
001110111111111111011110000000
000100010000001010001011111111
000100000000001010001010010001
000100010000001110001110000001
111110111110001100000110010001
100000000010001110001111110001
100000000010001010001010010001
100000000010001110001113000001
100000000010001100000110010001
100000000000001110001111110001
100000000010001010001010010001
100000000010001010001010000001
100000000010001111011110010001
100000000010001000000011110001
111110111110001000000010000001
000100010010001000000000000001
000100010010001000000010000001
000100010010001000000011011111
000100010010001111011110001000
011100011110001010001010001000
010000000000001110001010001000
010000000000000210001011111000
010000000000001111111000000000
011111111111111000000000000000
X