X001111111000001111111110000000
001000001111111000000011111000
001000001000001000000010001000
001000004000004000000040001000
001000001000001000000010001000
001000001111111000000011111000
001114111111111111411110000000
000100010000001010001011111111
000100040000001010001010010001
000100010000001110001110040001
111114111110001100000110010001
100000000010001110001111110001
100000000010001010001010010001
100000000010001110001113040001
100000000010001100000110010001
100000000040001110001111110001
100000000010001010001010010001
100000000010001010001010040001
100000000010001111411110010001
100000000010001000000011110001
111114111110001000000010000001
000100010010001000000040000001
000100010010001000000010000001
000100010010001000000011411111
000100010010001111411110001000
011100011110001010001010001000
010000000000001110001010001000
010000000000004210001011111000
010000000000001111111000000000
011111111111111000000000000000
X000000000011100000000000011111
011111111012100000000000010001
010010001110111111111111110001
010000001000001000000000010001
010010001000000000000000000001
011110001000001000000000010001
010010001111111111111100010001
010000001000000100000000010001
010010001000000100000000011111
111111011000000100000000011111
100000001001101111111110110001
103000000001000100000100010001
100000001001000101110100010001
111111111111000111011100011011
010000000000000100000100010001
010000000000000000000000000001
010000000000000100000100010001
010001111111111111011100010001
010001000000000101110100010001
010001000000000111111100010001
010000000000000100000110110001
010001000000000100000100010001
011011000000000100000100010001
010001000000000100000100010001
010000000000000100000000010001
010001000000000100000100010001
010001000000000100000100000001
010001111111111100000100000001
010001000000000100000100000001
011111000000000111111111111111
X