X111111111111111111111111111111
100000010000000000100000000001
100000010000000000100000000001
100000000000010000100000000001
100000000000010000100000000001
100000010000000100100000000001
100000010000000100000000000001
111111111110000000000000000001
100000000000000000100000000001
100000000010011111111111111111
100000000010010000000000000001
100000000010000000000000000001
100000000010010001000000010001
101010100010010001000000010001
101010101110010000000010010001
101010101000010001000000010001
101010101000010000000000000001
101111100000000001001110000001
100000001000010000000000000001
111111111111111111111111111111
X111111111111111111111111111111
100000010000000000100000000001
100000010000000000100000000001
100000000000010000100000000001
100000000000010000100000000001
100010010000000100100000000001
100000010000000100000000000001
111111111110000000000000000001
100000000000000000100000000001
100000000010011111111111111111
100000000010010000000000000001
100000000010000000000000000001
100000000010010001000000010001
101010100010010001000000010001
101010101110010000000010010001
101010101000010001000000010001
101010101000010000000000000001
101111100000000001001110000001
100000001000010000000000000001
111111111111111111111111111111
X