X001111111000001111111110000000
001000001111111000000011111000
001000001000001000000010001000
001005004000004000500040001000
001000001000001000000010001000
001000001111111000000011111000
001114111111111111411110000000
000100010000001010001011111111
000100040000001010001010010001
000100010000001110001110040001
111114111110001100000110010001
100000000010001110001111110001
100000000010001010501010010001
100000050010001110001113040501
100000000010001100000110010001
100000000040501110001111110001
100000000010001010001010010001
100500000010001010001010040001
100000000010001111411110010001
100000000010001000000011110001
111114111110001000000010000001
000100010010001000500040000001
000100010010001000000010000001
000100010010001000000011411111
000100010010001111411110001000
011100011110001010001010001000
010000000000001110001010001000
010005000000004210001011111000
010000000000001111111000000000
011111111111111000000000000000
X000000000011100000000000011111
011111111012100000000000010001
010010001114111111111111110001
010040001000001000000000010001
010010001000004000000000040001
011110001000001000000000010001
010010001111111111111100010001
010040001000000100000000010001
010010001000000100000000011111
111111411000000100000000011111
100000001001141111111114110001
103000004001000100000100010001
100000001001000101110100010001
111111111111000111011100011411
010000000000000100000100010001
010000000000000400000400040001
010000000000000100000100010001
010001111111111111011100010001
010001000000000101110100010001
010001000000000111111100010001
010004000000000100000114110001
010001000000000100000100010001
011411000000000100000100010001
010001000000000100000100010001
010004000000000100000400010001
010001000000000100000100010001
010001000000000100000100000001
010001111111111100000100000001
010001000000000100000100000001
011111000000000111111111111111
X000000000011111111111111111110
111111111110001000000000000010
100100010010000000000000000010
100000000010001000000000000010
100100010011111111111111100010
111100011111111111111111110111
100100010010100010010001000001
100000000010100000010001010101
100100010011100010000001000001
111100011112000010000000000001
100100010011100010000001000001
100000000010100000010001010101
100100010010100010010001000001
111110111111111111111111110111
100100000001000000000000000001
100100000001000000000000000001
100100000001000000000000000001
100000010001000111111111110111
100100010001000100000001000001
111110110001000100000001000001
100000010001000100000000000001
103000010000000100000001000001
100000010001000100000001000001
111110111011111111101111110111
100100010001000010000000000001
100000010001000000000000000001
100100000001000010000000000001
100100000001111111111111111111
100100000001000000000000000000
111111111111000000000000000000
X